lem_gfdqnu	pos_nwuzjq	tok_pdsbeb
lem_jtuhwc	pos_qkvpdq	tok_ebxvhz
lem_guxqgv	pos_ehupak	tok_jdswrg
lem_sjggqt	pos_htayhs	tok_oyrpif
lem_vhaocb	pos_bnvexi	tok_uwqjtj
lem_wljofl	pos_uwlevn	tok_xijnla
lem_pyzxcr	pos_wcngiu	tok_qqqzbb
lem_vmhdhe	pos_injexe	tok_kjthhu
lem_mzipht	pos_wihweo	tok_wmhaey
lem_uvxkzg	pos_pufjla	tok_ixrckf

lem_jtphzk	pos_pmcitq	tok_dnkwur
lem_dzzgwa	pos_gnginp	tok_smqdlt
lem_dfvmoh	pos_thsqcw	tok_czqghu
lem_ylldjx	pos_vpnzdz	tok_mgqdog
lem_gdcymo	pos_qizuyj	tok_mpoyge
lem_blswmx	pos_ofewxd	tok_yrhazm
lem_vbmwsn	pos_pcbrqn	tok_hyndvw
lem_rsigog	pos_hsbjaa	tok_bncvto
lem_uizcsj	pos_gxyohx	tok_ckqjwy
lem_anreid	pos_xofyih	tok_ivekmd

lem_mfjurv	pos_iuvqwl	tok_rtlxxu
lem_udnmaj	pos_kxiyzl	tok_wuzxxc
lem_clmsdl	pos_rqplkq	tok_welcvi
lem_vyseky	pos_dcpbem	tok_heyjym
lem_hxbufp	pos_wxpsqy	tok_xurumg
lem_zbwpxc	pos_bmluia	tok_ykqaom
lem_gfeafu	pos_xhjhwu	tok_hpbiur
lem_ommham	pos_gzvjcb	tok_boehfy
lem_lxvuzv	pos_foadfp	tok_xpfyxf
lem_eckpfg	pos_rlttsv	tok_yyauxh

lem_ehejdy	pos_fkefzu	tok_cowfrs
lem_wzndfl	pos_fwxmlr	tok_fxjlax
lem_uirpeg	pos_cubpto	tok_gxppbk
lem_ldmmwy	pos_mzfrsw	tok_kceqfn
lem_oeehst	pos_pzjxga	tok_xcrmgg
lem_waehpw	pos_hqwknv	tok_iuhaqi
lem_yqmcym	pos_welheb	tok_ozaipr
lem_uizoap	pos_wtsecz	tok_xeklhd
lem_elqjaf	pos_xizycu	tok_yfwiys
lem_oxbpma	pos_hvejep	tok_xgmsfz

lem_kvonsd	pos_acwxgm	tok_ssbbsk
lem_drxcvj	pos_oxxoih	tok_hqwmpn
lem_frvtls	pos_yuvdbn	tok_nvafrq
lem_ihzvwr	pos_huxeyz	tok_uavkty
lem_pukxrr	pos_ngcjfm	tok_kiezrp
lem_wjmgcn	pos_nyvleq	tok_wpdkuk
lem_ixakwb	pos_qedopt	tok_hqmzxa
lem_fyjaic	pos_velfce	tok_ljcyrl
lem_ithvcs	pos_qyjmzo	tok_lgpfek
lem_olqbjx	pos_hhaooc	tok_ixqaah

lem_avfwrs	pos_jecmuf	tok_ezidmw
lem_zlaiff	pos_wvbwgv	tok_hpurdm
lem_wyqkuu	pos_bwxveg	tok_txoyqf
lem_zropgk	pos_yrmmgv	tok_hwhagm
lem_uueify	pos_nnvfxt	tok_zgzpjp
lem_fpwefq	pos_uolyfd	tok_bdoanb
lem_skyiuu	pos_upgzkh	tok_pmyggs
lem_ohjrbd	pos_snnezp	tok_rczdgg
lem_xkccmp	pos_oefqfz	tok_paxfjn
lem_njkemd	pos_fslnyu	tok_ykhung

lem_qiozfx	pos_aztlxz	tok_zigmkf
lem_djxxdu	pos_imssir	tok_oaqwmu
lem_mvbuiq	pos_wnltzf	tok_apynxb
lem_zinbsr	pos_guiiql	tok_itjxly
lem_pppsal	pos_fgmnxp	tok_eouvcv
lem_zlwwzn	pos_sbrkip	tok_yairqa
lem_kxafmo	pos_tahrqi	tok_haamwe
lem_kuqyxs	pos_nnxnis	tok_joavzm
lem_bfdfkr	pos_dkjomn	tok_wmppol
lem_ozcdjl	pos_livcam	tok_jolxma

lem_gcqjba	pos_oexwyf	tok_doqyhm
lem_fntvul	pos_aaquyc	tok_xwrhvp
lem_umdplq	pos_ktbxir	tok_ekqehw
lem_jlwmol	pos_fwlyvv	tok_twzgrz
lem_uxcskg	pos_fpktiw	tok_piuzzu
lem_hsexdj	pos_iwfxgq	tok_jvlwgf
lem_atoxnh	pos_hbcazn	tok_jsqqxs
lem_annswt	pos_dzaaev	tok_ajctrg
lem_ifofsa	pos_mudsye	tok_urkpiu
lem_xikciw	pos_syvqqc	tok_etbvum

lem_prsbxb	pos_ynrcao	tok_zddvgs
lem_onskyy	pos_lfzsnd	tok_wvgtey
lem_xuxtls	pos_tkedxb	tok_hgrctv
lem_tpmfdm	pos_lipmdq	tok_xbgrey
lem_ktqkgr	pos_nxluxn	tok_bithif
lem_zkhxhp	pos_mbsoji	tok_amddgu
lem_kyfaws	pos_eaftpm	tok_bhwvlh
lem_wzyjdt	pos_anpbgf	tok_oynffv
lem_ydgmla	pos_xgdoql	tok_nnwcrg
lem_hmmkut	pos_djuwct	tok_qqjmhm

lem_fjgkar	pos_tqhsjt	tok_iikqst
lem_wuwaqx	pos_rhaxfn	tok_ebpybx
lem_vijhlp	pos_ezddcb	tok_exkcff
lem_wpmesr	pos_wyzeof	tok_ouujmp
lem_rlsmrl	pos_hrlhmg	tok_bsmjps
lem_bawppm	pos_tppuyt	tok_ptdpzk
lem_ffvgll	pos_qoyslz	tok_evadlh
lem_xjhrsf	pos_mmtjot	tok_efiswk
lem_mznezl	pos_ygixbi	tok_epdico
lem_mwjnak	pos_rqjenm	tok_aaghdw

lem_cfugrn	pos_thkymx	tok_gyagep
lem_cravnv	pos_hixfyo	tok_bhanmo
lem_rdplck	pos_lmifvp	tok_ngmgfa
lem_qtuhak	pos_zchxwy	tok_dhtcal
lem_qeqjwv	pos_dkmfbt	tok_rdfsym
lem_pjkmak	pos_tftbhs	tok_neukiv
lem_pcetew	pos_pvulyn	tok_hqfkyn
lem_ajoxth	pos_zruhqw	tok_ebsfpd
lem_osvhzh	pos_scckey	tok_dishno
lem_hyursx	pos_rshgty	tok_ysxzwq

lem_lqpirp	pos_jbpolq	tok_vazafx
lem_rvdeuo	pos_dzmccw	tok_gegpks
lem_jwqffg	pos_lnxodl	tok_jgxgpz
lem_rjwuwy	pos_cadats	tok_yeqiow
lem_ueesqu	pos_nwiiwv	tok_pohhea
lem_emfuar	pos_jvirac	tok_abqqji
lem_ogfjjh	pos_szsuza	tok_tabgvm
lem_pndamg	pos_rwgldl	tok_tqudai
lem_iywpiq	pos_djndzr	tok_hxjklu
lem_vqcqqo	pos_onxyxw	tok_zugext

lem_ajemad	pos_abjkzf	tok_rjevuf
lem_bxqhej	pos_rtzgmx	tok_irrktm
lem_druavn	pos_nujegv	tok_ectxkw
lem_lyasdg	pos_mnutvg	tok_fwvvrc
lem_sfznmk	pos_lfxwgr	tok_szaavf
lem_sbsjdd	pos_dozpjr	tok_zbzknd
lem_kvgles	pos_fhogxy	tok_taccsm
lem_fcqtpx	pos_tmgcrb	tok_qbkikd
lem_psvbfk	pos_jqyskj	tok_rduell
lem_fbgnsk	pos_itvrlr	tok_urfspk

lem_zlnksr	pos_qniadq	tok_mnhifo
lem_gewmtg	pos_iooisd	tok_mkedwh
lem_vppxcu	pos_mfhaax	tok_cqjpij
lem_gvifwv	pos_xkxkfm	tok_hvbudb
lem_sladpx	pos_qshzaw	tok_ydnmrs
lem_bnopal	pos_rxxfww	tok_gmbium
lem_donmkk	pos_vewkdf	tok_nynzer
lem_yeemuc	pos_nnurus	tok_edvwtu
lem_xgvluo	pos_mmkxck	tok_ydmfge
lem_jutsbb	pos_sqftce	tok_vzawpp

lem_jhqoqs	pos_ihmyxb	tok_yfyrea
lem_nkvlnx	pos_aqvhio	tok_nnelpw
lem_gxkkoc	pos_daltlm	tok_jorbqw
lem_ulrtdw	pos_srnqjs	tok_zfvikl
lem_uabzia	pos_toagij	tok_qxtcpy
lem_tzwyub	pos_dtjufi	tok_ixvpvt
lem_fusqdv	pos_jtqthi	tok_hzukad
lem_ndyycw	pos_zvyagi	tok_dpnsss
lem_fgoitw	pos_wmaosb	tok_sfkntx
lem_ujsciq	pos_xshrpc	tok_ebzffk

lem_xutjil	pos_adclgo	tok_upezoo
lem_ixaanl	pos_llfvjy	tok_dtsfgg
lem_phwitw	pos_pgioae	tok_cyjwtq
lem_qmcwig	pos_ecytfd	tok_ufagep
lem_bbflme	pos_iqjpts	tok_czdsri
lem_deneph	pos_igdlib	tok_bmaizm
lem_ocnfid	pos_saklbk	tok_xokkhl
lem_geiuof	pos_wstmda	tok_nlcyec
lem_iwuxxw	pos_dgzjoy	tok_cdbnnm
lem_nvxuvz	pos_uhodcc	tok_dnvvwg

lem_cqnsbo	pos_pwadgr	tok_kortuj
lem_anvqxk	pos_yccvjf	tok_ampwll
lem_nwvyas	pos_tbydky	tok_mrcayc
lem_cyptsq	pos_iphsup	tok_kztqgr
lem_fxsbex	pos_npemmd	tok_davhpt
lem_aekkky	pos_hguizw	tok_jpklwv
lem_nlprwl	pos_pvinyd	tok_gmdagq
lem_xxobjw	pos_nkrsfd	tok_bujtdl
lem_zxokri	pos_uirync	tok_rhnaim
lem_ehavud	pos_unssnr	tok_azrcug

lem_laagva	pos_wbmkga	tok_plrqcy
lem_tnabku	pos_tiindw	tok_ogxljr
lem_cmbgsk	pos_cdywvr	tok_xcbwrw
lem_hnnnij	pos_qrfymf	tok_crwhuq
lem_iqzezq	pos_ykndtn	tok_irqwns
lem_skzyai	pos_mxlyrs	tok_wlurhe
lem_fnxwvk	pos_bnnijw	tok_bkkmji
lem_svgooe	pos_krgptc	tok_jrqtry
lem_assxwo	pos_omdyzx	tok_sgvsxv
lem_hvdgwz	pos_vrgeow	tok_tonrvq

lem_ticbwy	pos_snivqr	tok_lyuygc
lem_dsmjsj	pos_rbhzpc	tok_wxixkc
lem_skclnj	pos_wibgje	tok_njlufj
lem_atelfh	pos_gywost	tok_jpbieo
lem_idetrp	pos_mhvsob	tok_abulej
lem_tcalax	pos_nedduk	tok_paoezt
lem_bncazo	pos_amfnxh	tok_jxdmpq
lem_nwdaon	pos_zvwvdk	tok_jtzspc
lem_kbfksu	pos_gzgdoq	tok_pkvgoy
lem_gmzvkk	pos_irzvnj	tok_cnseuw

lem_tzlsch	pos_bkjvqo	tok_qqfszl
lem_fytfer	pos_jlyhci	tok_hljuwb
lem_fqzmxm	pos_ucdwkn	tok_bltjkt
lem_zlavqs	pos_pnauav	tok_fqliys
lem_upyjpk	pos_ljgesp	tok_ebbmgl
lem_goqobs	pos_bmuenn	tok_fncglz
lem_hudmem	pos_kpbjpq	tok_vimhsd
lem_fzifbh	pos_aipmub	tok_ntxgsc
lem_krzzbl	pos_scfjmu	tok_pbiemy
lem_ptegqc	pos_doglkq	tok_ipmpiq

lem_klmyfi	pos_occvyo	tok_tshwre
lem_hikvdz	pos_edbhdc	tok_nnldcw
lem_ypdhrw	pos_mtjrcc	tok_mbcqcg
lem_fqksnl	pos_jwfxnp	tok_cypayv
lem_evcfsi	pos_dttldp	tok_webnbk
lem_ibyzvt	pos_qewpgj	tok_yrjlhg
lem_qkgrvm	pos_ktptyv	tok_kadqgf
lem_nxcqvc	pos_wdlzbr	tok_froxou
lem_nhvqen	pos_kkfevq	tok_survdh
lem_moouml	pos_wzpyxo	tok_bpqtpm

lem_ojplcl	pos_zyszct	tok_zgmelo
lem_hgqjnp	pos_ouflgq	tok_fxjxpi
lem_djfjop	pos_ziljar	tok_xmpmcq
lem_jeoykt	pos_xksutm	tok_jfoyoq
lem_hequrp	pos_objiod	tok_xpcixd
lem_bjodxt	pos_ccrnem	tok_oqibha
lem_wbrifc	pos_jlmhnq	tok_xgyutd
lem_rdgoyk	pos_cleaau	tok_htrzdi
lem_ukwxbt	pos_oxixux	tok_fjwoar
lem_bffybk	pos_qgiflp	tok_orilxp

lem_dzfpzx	pos_mfzxlp	tok_pehmff
lem_hfqgig	pos_nkjvhi	tok_ouofwp
lem_ssavei	pos_yosrny	tok_ptcybg
lem_peahtp	pos_mzlfjg	tok_pyiaej
lem_bthzlb	pos_mtfqms	tok_edqcrm
lem_tifmlv	pos_svkguv	tok_wnllfv
lem_iajvko	pos_qihveq	tok_zoeylb
lem_rnmfta	pos_jqhmhr	tok_qnfefw
lem_zbvoet	pos_pyqtzr	tok_jvvlfu
lem_vxiant	pos_uollaq	tok_hmlkab

lem_pvzaap	pos_kwjlav	tok_hloelw
lem_ineheu	pos_chtsfm	tok_oriwno
lem_mhwkcz	pos_wbjycg	tok_ajjtyn
lem_dhkidv	pos_mnrlqg	tok_dydyzf
lem_uzerdx	pos_uwtnpj	tok_nfrasy
lem_kimtmg	pos_dosyzo	tok_ilmbes
lem_kfgynq	pos_vrpcgt	tok_hlybfg
lem_pnvdmh	pos_fqinev	tok_xfooor
lem_jsjzaj	pos_risrfh	tok_sdqucs
lem_jlaejs	pos_psudfw	tok_hycysr

lem_qgqsct	pos_ksspir	tok_csbvjf
lem_rmnpfz	pos_dyvrkq	tok_vocljk
lem_qmappz	pos_uhfxyg	tok_wrldjy
lem_fdydmo	pos_duwjng	tok_esvrln
lem_tyifjh	pos_ywyzqq	tok_nnpkto
lem_rivwnz	pos_ublpfh	tok_vfvtpx
lem_qhxgdc	pos_oewtgi	tok_fugmmi
lem_ftfsgs	pos_tfirgw	tok_knunat
lem_chixfg	pos_negxro	tok_rdcjdx
lem_uzqrej	pos_uvposr	tok_uohnip

lem_jxemra	pos_rkbrbk	tok_ifhxce
lem_olzhtv	pos_jfrywh	tok_yhvihd
lem_ydgohk	pos_hszrqx	tok_tlarpc
lem_zqglyf	pos_ecedbz	tok_lemvxl
lem_ypjaxo	pos_zfqntt	tok_rqbccq
lem_swxsyq	pos_wlgmcg	tok_gdkilr
lem_arpdhf	pos_ghimin	tok_logvyv
lem_xmzdmn	pos_dmfrit	tok_edstut
lem_uorbwq	pos_sftqsm	tok_sanfoa
lem_pczgzy	pos_qoezvl	tok_zaptlx

lem_lfxiwb	pos_djgaer	tok_oivhxm
lem_gkojxc	pos_emybwc	tok_yvptil
lem_jkaufn	pos_ohlrgi	tok_izmquh
lem_bbwrkq	pos_glsqyo	tok_iuzqwl
lem_dnpbzc	pos_qxptxb	tok_qwyfem
lem_lewjlv	pos_ywqhum	tok_ixjyol
lem_mqqfli	pos_wqsuny	tok_etheob
lem_bmlwcn	pos_gaxxdc	tok_gxhrkp
lem_ogdatb	pos_povwgi	tok_bdhwqb
lem_ywllkd	pos_reegdz	tok_bhhlgo

lem_nlllvc	pos_ifwccy	tok_hpofjd
lem_rvbtak	pos_zkvflq	tok_szpltj
lem_jxgesb	pos_fiytll	tok_mbrmdl
lem_otawdu	pos_kjdjbp	tok_pykwfn
lem_ijfzdv	pos_ghayen	tok_bwnkny
lem_zpvgcp	pos_nlkqey	tok_nwstwc
lem_snrvbm	pos_yssbop	tok_khlcdg
lem_tiesze	pos_mtvjen	tok_sdvzuv
lem_ctsgno	pos_dawnws	tok_pofuep
lem_hjnwef	pos_fprfsp	tok_lsjguh

lem_fxbmid	pos_cobxim	tok_mekzbl
lem_ovmyis	pos_mpqdzw	tok_nijxgd
lem_ooscrj	pos_bhnasz	tok_efzveb
lem_jjrcaq	pos_yrjlnz	tok_pxoyxj
lem_zruscz	pos_jqlsfz	tok_xgkxog
lem_yetvik	pos_havmzy	tok_hpnpph
lem_viyswd	pos_kjsboc	tok_frehzz
lem_njrseq	pos_nizvov	tok_zwqtaw
lem_cyzlqz	pos_iuvhcf	tok_byybvp
lem_hatdhz	pos_jxrypo	tok_dcszlg

lem_dzqrub	pos_xcggki	tok_qxdmyl
lem_jgsfzd	pos_lcyjne	tok_ymorme
lem_zrahry	pos_ykjkgs	tok_iuyyoz
lem_ujqjpc	pos_mwkvez	tok_zavudf
lem_ylyero	pos_xkqvdv	tok_kueygb
lem_akrtkf	pos_upphpq	tok_lozazk
lem_tynjxv	pos_hnfisf	tok_nlfpod
lem_aynhvz	pos_jhfdez	tok_vjwgrx
lem_dvrvoz	pos_ghbton	tok_eijeqe
lem_rwnckj	pos_qxtbrp	tok_hnymqy

lem_yeezsf	pos_edgtfl	tok_huepha
lem_fnbmwa	pos_xexppm	tok_jnbhtt
lem_cdvath	pos_neusbc	tok_goeiev
lem_gzxbkl	pos_wkwjrs	tok_nrcybz
lem_aalrba	pos_bziloj	tok_vmhqob
lem_ubyqps	pos_wgtscc	tok_djigqo
lem_etcvry	pos_viqkgx	tok_ccwsez
lem_rwmldm	pos_gpqhwa	tok_fdodho
lem_chcwrl	pos_srwglr	tok_rvdfge
lem_hevyyu	pos_kmrwse	tok_jqykzl

lem_dgrwgx	pos_ekpepq	tok_nbaaxm
lem_quehtr	pos_pbtwtz	tok_wtaeak
lem_xjacfo	pos_jvycod	tok_yklfvp
lem_tqpycj	pos_ehfdln	tok_exkbvj
lem_rqzwuj	pos_cgcqdj	tok_syzzow
lem_hdxrwc	pos_nbhrgt	tok_sxvjlo
lem_sfvquy	pos_bevjtv	tok_zetzen
lem_oexsez	pos_sbasan	tok_mdcsdi
lem_lnszds	pos_hhfxuc	tok_vlgtji
lem_miujhn	pos_frqxep	tok_gedpqp

lem_saahbi	pos_wxfkrp	tok_tegsiq
lem_zzqnzm	pos_vdemgo	tok_prrcap
lem_aemczs	pos_fhaeff	tok_txgkqe
lem_kwhznc	pos_syakvr	tok_kogsme
lem_vwkozu	pos_rijwtb	tok_usowkw
lem_fnzqji	pos_katfwf	tok_kiuttf
lem_msucrn	pos_lzhcej	tok_jeiecc
lem_iheaua	pos_retrne	tok_iukohv
lem_hjrleb	pos_eppbih	tok_owrxoo
lem_juavaj	pos_ukicbx	tok_ycgtfl

lem_prtjto	pos_bzegei	tok_uyblvv
lem_scseuz	pos_titmtm	tok_lhmzbp
lem_oixgqw	pos_yyfmko	tok_jhojkh
lem_uyeqjr	pos_hljdgn	tok_mljgaj
lem_ddxibu	pos_akoluc	tok_bovioq
lem_cehnmv	pos_qwdqtn	tok_dtvkvt
lem_xuxfji	pos_zlsndz	tok_qiogqv
lem_jnytve	pos_gfkxlt	tok_inlzat
lem_zfhbxe	pos_xobyju	tok_lcbacs
lem_sjlbas	pos_ttfjul	tok_sqkwlg

lem_awjirn	pos_ouhwax	tok_mqsghi
lem_ofeegs	pos_smxjgx	tok_rfolii
lem_atswby	pos_fenkvc	tok_gqwikq
lem_pgxdiw	pos_dsrwjc	tok_tflanb
lem_qzhmel	pos_rhztps	tok_qluigd
lem_bvdbmp	pos_zncjcd	tok_vsuewx
lem_sgxcxc	pos_epblbc	tok_dcmpck
lem_xdvgiz	pos_doaoyj	tok_mpuqew
lem_odyrfg	pos_nhhexe	tok_pdzelw
lem_ylzdgt	pos_csyilk	tok_bppluv

lem_ldleif	pos_nqrjxg	tok_llyips
lem_kymady	pos_kcjbvp	tok_xrcbnt
lem_kklwpq	pos_wfievh	tok_nyxktk
lem_yioeks	pos_syomgn	tok_nsymqf
lem_uopydm	pos_ptjzva	tok_giubnu
lem_hhyqgy	pos_gvwdcy	tok_kvkuks
lem_qrztso	pos_clcsna	tok_vaewey
lem_nhhwzj	pos_ezgloi	tok_eblrbl
lem_yyjamz	pos_xercqz	tok_jnosbg
lem_cojxgh	pos_zingfl	tok_wmpjhu

lem_luxbuk	pos_cxonar	tok_cwplgr
lem_qatioz	pos_dylzyf	tok_pcapsv
lem_dzufzk	pos_ytspme	tok_gxditb
lem_yubxcy	pos_uzwutg	tok_sjajgt
lem_gcozwx	pos_beyboh	tok_kktcrs
lem_hanobv	pos_qnsyiv	tok_bsfxkz
lem_elkdde	pos_wzrtnd	tok_hoxyrh
lem_jzdimc	pos_zkijnh	tok_zlvbkr
lem_hmmmlv	pos_lnlfea	tok_jjbaaz
lem_tzqmkq	pos_vjhhxt	tok_ruslel

lem_mjqeom	pos_gebztq	tok_aerazk
lem_upfusg	pos_uymcnl	tok_czdbnp
lem_hllsio	pos_adizyc	tok_qphapl
lem_awlgsj	pos_fszhpv	tok_sxsdzv
lem_xeuaam	pos_ddjbrb	tok_luddyr
lem_tpybvy	pos_bbopwa	tok_edwrrd
lem_vgoehd	pos_xuypjw	tok_efglsk
lem_zzfczt	pos_vjatsq	tok_emycex
lem_szcxpt	pos_nojbqn	tok_edhumk
lem_ispltv	pos_tsgpnu	tok_rpcvjq

lem_mbkvhi	pos_smppuu	tok_pxndhj
lem_meivyh	pos_gptann	tok_sdjffp
lem_nxascw	pos_thoscw	tok_pzwxko
lem_xphiue	pos_mubpmk	tok_ddwxhy
lem_vkrwdz	pos_eehypc	tok_duejpg
lem_zjfyxc	pos_zxizul	tok_hdcxcl
lem_mulutt	pos_oqcxhb	tok_htymmg
lem_xjnxbv	pos_hvvefp	tok_waszok
lem_iiuvxl	pos_ugokos	tok_hajzte
lem_slueez	pos_doxobb	tok_scxheq

lem_oqipqu	pos_wirxjd	tok_xoddxt
lem_wynqzb	pos_gzuzum	tok_yawpve
lem_lwighy	pos_ghtfcr	tok_hudyiu
lem_jrycuz	pos_nlfuwx	tok_mdjomx
lem_nzhlcs	pos_vnbobw	tok_lsiqpr
lem_djmiqw	pos_dqnjft	tok_ycwdbr
lem_qbiifh	pos_zsejfw	tok_iohtrz
lem_gquaos	pos_vrrfeh	tok_goglgo
lem_sljycv	pos_ugcecq	tok_mooblo
lem_ukztbi	pos_fvqrwt	tok_fvekhb

lem_xyjecp	pos_bngwhd	tok_aahvsy
lem_gqtips	pos_ujjrcw	tok_aeeagn
lem_uzmhzh	pos_sdrpev	tok_yasdcw
lem_aifxsa	pos_pgzaro	tok_dvrxuz
lem_kdgtlg	pos_nmbpkv	tok_qcmfhq
lem_akitwl	pos_iqemah	tok_rupfks
lem_zrnmed	pos_jrztme	tok_wjvtlr
lem_vrbkpt	pos_zrdrat	tok_lyqree
lem_prncga	pos_gprvez	tok_hurmbi
lem_dlmgek	pos_vkyrco	tok_cxrptf

lem_bxskvg	pos_zmnhqk	tok_tzdike
lem_lsnlte	pos_coqune	tok_zlbmnz
lem_wtdaxy	pos_cmlzid	tok_epvwwo
lem_qnvbib	pos_qgrkky	tok_fzesoz
lem_ccivwi	pos_pmhcrq	tok_wnrebr
lem_pykjmx	pos_avqjes	tok_qugjqm
lem_illjpl	pos_ghcuqm	tok_swogfp
lem_tdrfaa	pos_sflkoy	tok_kjkztg
lem_qwrgrd	pos_nolwqs	tok_jiihqr
lem_gfccmy	pos_vuyicj	tok_ocncea

lem_tjgrnl	pos_nqepwm	tok_rksrmn
lem_jmtheh	pos_ajlnmn	tok_vhmszx
lem_byazwu	pos_cduxqf	tok_uwrpcg
lem_byikfk	pos_gvgrag	tok_juefzj
lem_kgrpzq	pos_ahluev	tok_stlvkd
lem_nyukqs	pos_qyzolu	tok_tstswn
lem_jomvhs	pos_cdcarb	tok_fxqfot
lem_unsenp	pos_bflezv	tok_wwyjkc
lem_zimsxz	pos_xurwzl	tok_rrjmkb
lem_qvjald	pos_qdbrdt	tok_cxzvzm

lem_ewxsgx	pos_ajgckx	tok_beritv
lem_mpxaid	pos_ylzbfl	tok_aodlve
lem_fujsxz	pos_ahphjs	tok_bodsvu
lem_lifzal	pos_nkzgmd	tok_wqfhzu
lem_izvkug	pos_cpczbr	tok_eibvst
lem_ohggnv	pos_ojhwiw	tok_puhifc
lem_cyygzr	pos_yumcfe	tok_kdxdam
lem_gtbluo	pos_qbvlct	tok_djmsjc
lem_amjqcn	pos_qsexly	tok_rljvrs
lem_vshriq	pos_kawwnk	tok_sivtbf

lem_dfqhkf	pos_qjjksy	tok_dcjjtj
lem_ivdeai	pos_ablhhd	tok_lbnksw
lem_eykqmj	pos_achgqb	tok_errdti
lem_cgfxgj	pos_yeicru	tok_gmcttt
lem_hfchhv	pos_bbmgsg	tok_ihxtuc
lem_pwcjmf	pos_cktnuz	tok_sgzbur
lem_vjrcwc	pos_eliuud	tok_opeihi
lem_vfeury	pos_oabjwv	tok_vtxnuk
lem_ojptmn	pos_nmcckm	tok_ieeqii
lem_zityox	pos_plcaie	tok_hjhqle

lem_eicsff	pos_uysimb	tok_rhbfqq
lem_swawvt	pos_zwcgjj	tok_mpfzmc
lem_hxdyjy	pos_uuklje	tok_vzwcez
lem_qtugzm	pos_rtagrp	tok_wewuqn
lem_dgpeht	pos_kowrmu	tok_kdrmep
lem_ywgaxh	pos_lrhasu	tok_oyxara
lem_tjtpyv	pos_qkftmv	tok_rfocys
lem_yodrrt	pos_kqfomy	tok_hikxzm
lem_xqsoty	pos_usrjwj	tok_nzsrey
lem_vahsmi	pos_jdhxzz	tok_hzssny

lem_sxqrgo	pos_utfkbp	tok_pgmuak
lem_upulmg	pos_ogkzfn	tok_vpwuna
lem_qxxzra	pos_kzofah	tok_mojdrd
lem_stteyb	pos_whjryn	tok_ahhjhx
lem_imlvws	pos_xkjjyv	tok_tpeqhp
lem_mkqbql	pos_srhtfo	tok_tjejdh
lem_srdtbv	pos_chloqp	tok_ssnijc
lem_uswkyg	pos_vdicyb	tok_xqjhmz
lem_krlhld	pos_xgtbww	tok_crcazr
lem_rgustp	pos_hpmkfb	tok_kbrimt

lem_yztwhb	pos_hxwygf	tok_vmlqny
lem_qsljtl	pos_okueau	tok_uscadu
lem_sqcljt	pos_yoeuuo	tok_bufmmk
lem_vwdkvz	pos_zvlxdc	tok_iyfjxz
lem_fhyxld	pos_iwjeqh	tok_pxgswn
lem_nmyyde	pos_rtgmic	tok_rpznih
lem_nmryce	pos_lqrnqi	tok_oyzlal
lem_veooxl	pos_dgbfni	tok_xspltr
lem_yqdboa	pos_wlbwhs	tok_xykzxk
lem_egjpoj	pos_poklar	tok_iaongs

lem_oqhmht	pos_kokwdy	tok_eysfod
lem_niayce	pos_qtekzp	tok_vzxvlo
lem_wpeowt	pos_odrqay	tok_jxcrtx
lem_ojjzcg	pos_apfqio	tok_izeatu
lem_hgumyt	pos_fdqqzt	tok_vjshjc
lem_qqxfci	pos_tymmed	tok_pluasb
lem_vjzegn	pos_uljqtm	tok_iaxkyv
lem_bsrgfs	pos_wtqduj	tok_krqfsu
lem_ioolrt	pos_tafxue	tok_egcrqb
lem_wlpoqm	pos_mvcxyw	tok_qhiusm

lem_ijbaop	pos_splybr	tok_mqyixf
lem_laujzm	pos_bzzmmf	tok_faczbs
lem_wyagin	pos_aztpls	tok_jlxjra
lem_auhaiu	pos_uiuvju	tok_bkecxr
lem_dwkxfr	pos_eqvcxg	tok_ynnpma
lem_puxkvv	pos_vxdutd	tok_tjwtec
lem_ldvyty	pos_msmwey	tok_kmbshh
lem_iuqfhr	pos_kumdhv	tok_mlmqvt
lem_hbrwyy	pos_zixmcl	tok_zdgdce
lem_ilzezj	pos_twxphc	tok_yjnjwz

