lem_pnglqu	pos_asmebe	tok_psaspz
lem_mebgbd	pos_zvlbfv	tok_ezxvuu
lem_xzqkny	pos_mavawc	tok_bxenxg
lem_ghngfg	pos_pxvlyl	tok_lvodeu
lem_ylhvck	pos_iltuul	tok_mmqtsd
lem_wybloq	pos_jcxlix	tok_gdukqy
lem_bghzga	pos_jcgdsc	tok_bsormp
lem_fxthyj	pos_nibtuj	tok_lnvnfl
lem_axspcv	pos_btxixe	tok_ppdtve
lem_xewmht	pos_kvybim	tok_fuhesp

lem_myzkgo	pos_lxynbd	tok_cpjqfb
lem_ojtejj	pos_guuaor	tok_fvrhab
lem_mmukhu	pos_mqfvnc	tok_fnwube
lem_tnsgmx	pos_anxfmz	tok_ktfmas
lem_tmluif	pos_agcygo	tok_gtksyi
lem_iiudev	pos_wsuupd	tok_fnftzx
lem_tsytjo	pos_yecchj	tok_gzaqyb
lem_kbrglb	pos_jrsyty	tok_lhonek
lem_dbvtjj	pos_xuqywg	tok_izhkrh
lem_ehymrj	pos_jconao	tok_gimfgp

lem_qoxvdx	pos_xelnad	tok_fbzqzj
lem_yvdvaj	pos_xfysrm	tok_lfcgll
lem_ygqkqo	pos_pmbbbm	tok_tnxqzf
lem_lgcvjs	pos_wkecbv	tok_ecwrkb
lem_wlwibu	pos_mxabba	tok_howeal
lem_qezoyp	pos_ehsvhq	tok_aehlox
lem_gmgvbl	pos_xjywci	tok_ndleah
lem_dukmse	pos_boqhzt	tok_jyqpha
lem_yncpeu	pos_qmdcur	tok_luvxba
lem_wccpzf	pos_dwuage	tok_gsfpvu

lem_zgaeuh	pos_iebabk	tok_vjpipo
lem_egiwli	pos_pneaav	tok_lwncsp
lem_etdddt	pos_dfslho	tok_tcvxup
lem_piujkq	pos_jbtkzg	tok_ocawyd
lem_nvowjp	pos_zzflcu	tok_mgwyig
lem_dzbokl	pos_bgtmyq	tok_btcxaa
lem_uvunqw	pos_mjgnwg	tok_rmjtta
lem_iiggtz	pos_mpxicz	tok_bziitq
lem_oqkxln	pos_stzzex	tok_epkfvy
lem_vaglxh	pos_jqljvu	tok_jhcyqp

lem_zrdaut	pos_azcbgd	tok_eqspfr
lem_pahaia	pos_islakf	tok_vadzpo
lem_nrgboa	pos_ljxzgm	tok_dxbdmx
lem_rdipvv	pos_mdnylf	tok_cuubbc
lem_oshqgz	pos_xgwkmi	tok_gksedp
lem_aeylbl	pos_vntgwy	tok_ujfpcr
lem_kvzcce	pos_cliawz	tok_lsynrz
lem_jrwgfn	pos_clhgqa	tok_ilruyc
lem_mvjszq	pos_agbbcd	tok_clcciy
lem_aupvma	pos_wwlmdh	tok_xoalkn

lem_xnlhfr	pos_rhevie	tok_zekaok
lem_dhehjw	pos_aurleh	tok_nmakyf
lem_ankaqj	pos_esuowx	tok_rjltim
lem_vyugto	pos_ztvzxd	tok_nkzhsc
lem_uetvbf	pos_dixkyh	tok_gpxwdy
lem_wgjqvl	pos_fbijwc	tok_uhpgmb
lem_lbmsla	pos_qzipnp	tok_qwqcyy
lem_rdenyx	pos_smgvkc	tok_oojuer
lem_hiwtug	pos_osgiia	tok_kgrbky
lem_xvlgbu	pos_gbrncm	tok_rhcbnf

lem_rrijyv	pos_hhwgaj	tok_hglsmo
lem_mhfrtc	pos_gseabj	tok_gvbsrc
lem_uiljox	pos_grhpem	tok_fkrfzf
lem_jmrrud	pos_naxznl	tok_suyxme
lem_whypap	pos_nobacl	tok_cpbqgd
lem_msajlz	pos_pyoxmm	tok_wfjhwj
lem_ettsyw	pos_gbmuzc	tok_lapskd
lem_gujqny	pos_hcrckt	tok_gekwdi
lem_mpagjz	pos_mbpjcl	tok_dfwbdx
lem_ldreti	pos_lkiypk	tok_kvcurb

lem_vnypun	pos_gkjdef	tok_zqopre
lem_yhzsnm	pos_lowabu	tok_ifurtd
lem_svgolo	pos_yemjht	tok_mozohp
lem_hnncpk	pos_jnpizv	tok_uujfmo
lem_pbxxgy	pos_rwmksa	tok_tbgelf
lem_alxytf	pos_nmrber	tok_trwajw
lem_rcmzct	pos_dnbxuc	tok_zjgbht
lem_slzeww	pos_ueibpj	tok_spnicz
lem_oatvra	pos_jybjfq	tok_anaayc
lem_zdpeyz	pos_cebrvz	tok_jthzal

lem_bntofm	pos_jngleg	tok_qdpsqo
lem_fmrnyq	pos_tveybk	tok_qywgjg
lem_jfzdao	pos_efkukb	tok_terush
lem_msnztv	pos_avckvf	tok_rpdgdm
lem_vlqlqf	pos_vcmecr	tok_psjooy
lem_fjbpev	pos_wtdmbr	tok_duslbg
lem_wieira	pos_ydinmw	tok_gxpvdk
lem_cghfnf	pos_nlgplz	tok_yhqkbd
lem_rludli	pos_awqmwk	tok_rvkvog
lem_msfyup	pos_niipwh	tok_xysaww

lem_xvlzpl	pos_npdsdr	tok_hozwpw
lem_ezwduk	pos_bopbho	tok_ojphac
lem_gyjwdv	pos_bulihx	tok_ybwnla
lem_fxfuvg	pos_gwrsht	tok_iufari
lem_hvhhvu	pos_bfvbqu	tok_wrugav
lem_virrik	pos_bfusid	tok_osubgh
lem_igtllm	pos_zsmlgd	tok_vrguwy
lem_yvxfyo	pos_foicpg	tok_omidwp
lem_onshyh	pos_huzxvu	tok_xoqpol
lem_twcwrd	pos_xmmyii	tok_apeqno

lem_hwlcbf	pos_wvxtpu	tok_cwstqs
lem_idwhly	pos_uxqvdq	tok_wadnqq
lem_ghbdfe	pos_tdbmiz	tok_hcxois
lem_bfsrey	pos_yatuxi	tok_uoyzjy
lem_nexzlq	pos_rnxyvz	tok_xvruyn
lem_hobbrr	pos_piiaix	tok_uniyqj
lem_lpvloc	pos_axnzeh	tok_zatdex
lem_wczgrh	pos_upuwir	tok_nqbrli
lem_gosogu	pos_kkbarj	tok_xizwwg
lem_oeprnt	pos_olivpj	tok_clepiu

lem_omqxtp	pos_kehvtp	tok_hrerte
lem_pnowgn	pos_etrjvq	tok_mlwjjy
lem_zshfka	pos_bjqaoy	tok_kjwvbg
lem_rjxsbn	pos_pwonvp	tok_ssslob
lem_fwxdnl	pos_kujnyj	tok_gcqhia
lem_rdaszr	pos_psouih	tok_gjshkw
lem_qczbdv	pos_lyfkes	tok_judfss
lem_usczau	pos_buqpls	tok_pkjdmx
lem_uytagi	pos_uqntms	tok_lrjnln
lem_rwgfjv	pos_peezza	tok_dukgtz

lem_lyyhwq	pos_iwhhxe	tok_voswhx
lem_sewohc	pos_eszmdr	tok_mzgiqc
lem_fzvavh	pos_xfnjdb	tok_ytuboz
lem_ujyrdr	pos_hmmeaw	tok_emmmzw
lem_qfdkqh	pos_oakuls	tok_zjaurs
lem_iglmrn	pos_moqchd	tok_uebens
lem_grrils	pos_xnvdit	tok_kxkccr
lem_rahztc	pos_kvfbjb	tok_klpafn
lem_oujgyi	pos_iskgln	tok_vcxpps
lem_mdrbdm	pos_icrxxn	tok_astqym

lem_zvymaz	pos_nqchpv	tok_bdxugf
lem_doafwx	pos_eeensz	tok_ijygwa
lem_ecnrtu	pos_kdivkj	tok_ewgxfw
lem_vlzbui	pos_ykyihk	tok_logkvy
lem_wljjnn	pos_ejrqux	tok_qbswct
lem_jqktac	pos_mvpkvz	tok_rfyqtq
lem_miucap	pos_emmvel	tok_blubai
lem_qkspdn	pos_lagrww	tok_mfacah
lem_pyyoag	pos_yixzbw	tok_wsqjlc
lem_fahftc	pos_yebico	tok_ohzfke

lem_vbnhkb	pos_mkdjjo	tok_sifeia
lem_tfythp	pos_wxxaqg	tok_bhvhgg
lem_qhekoq	pos_hnqqgd	tok_lkfkvl
lem_juynha	pos_zwyxbj	tok_vmewqc
lem_xhvadu	pos_tsubsg	tok_ejaswn
lem_nwacfk	pos_avqxhm	tok_dxzihi
lem_mlkidd	pos_xtnfei	tok_tvurhr
lem_mjlcuz	pos_fsxxuf	tok_tvxcyq
lem_elurab	pos_fkeuji	tok_kodcqh
lem_jhtvfa	pos_riwebj	tok_wyfllm

lem_ehyuab	pos_azurxz	tok_lzhzlr
lem_hesbez	pos_cuhpuz	tok_ovolhm
lem_vpwjcg	pos_ejgsmo	tok_yabopn
lem_bdcgse	pos_bzuojo	tok_qdxkdx
lem_sajlgi	pos_uqxyji	tok_ffmpgu
lem_atdhzb	pos_renqzu	tok_plhuik
lem_wycrgt	pos_ptrfbb	tok_fcyifc
lem_idvbho	pos_ucnwzy	tok_qpqnlw
lem_ghsmbz	pos_fatumo	tok_kbffal
lem_jcynpn	pos_yltenm	tok_kczrkz

lem_dvweer	pos_krdjep	tok_yguwcv
lem_mudjnq	pos_uviakt	tok_murppk
lem_wjukub	pos_yggtkn	tok_zbdcjc
lem_znvoew	pos_zgfwer	tok_vqpnit
lem_gdaykn	pos_abktqv	tok_oytwun
lem_jukrnn	pos_pkuqyu	tok_jsyslm
lem_tzlegg	pos_kmoxfo	tok_jnqtpq
lem_ffpebz	pos_cxabab	tok_olouxz
lem_ljlbis	pos_gvewxv	tok_hvhgut
lem_yvhmck	pos_bmtppc	tok_upbyeu

lem_gtpqpp	pos_vgukly	tok_bkxnlu
lem_wkpmqw	pos_klxemb	tok_cgkcqs
lem_mprrnf	pos_zwwksf	tok_lldawn
lem_gjstsp	pos_lyktlo	tok_eqdswb
lem_iawrhv	pos_jnxifc	tok_jcoyys
lem_gikbbb	pos_hcfykc	tok_jhbaaj
lem_rworir	pos_menbpu	tok_lpthvx
lem_idxscs	pos_msnpth	tok_hjydha
lem_gxkksx	pos_hgwwvg	tok_ambhzx
lem_wrurbc	pos_deytsp	tok_bsdcgw

lem_ciifzj	pos_rwklqg	tok_annfjf
lem_hxlapr	pos_ytijwd	tok_uwfoew
lem_dakvmb	pos_dueirt	tok_lkiyjy
lem_orwffp	pos_xvpdsd	tok_ymjtmn
lem_jowzgo	pos_fjxiec	tok_mtndsk
lem_ccsjxk	pos_mnynch	tok_icfdkp
lem_bckheg	pos_iuwwfb	tok_gbsnmi
lem_qnrtpk	pos_nkaibd	tok_zptrjo
lem_ylyodz	pos_qusyxo	tok_rzoafu
lem_huscow	pos_mkjxjo	tok_hvpcub

lem_isigco	pos_abwiiz	tok_zcjhzt
lem_gctpta	pos_vlwfme	tok_rciavv
lem_rhutpw	pos_dqbkuz	tok_epwnzx
lem_nokcra	pos_bqhndh	tok_gawuji
lem_excjus	pos_vjznov	tok_wfysra
lem_vztfoz	pos_qnpmdl	tok_darejq
lem_nuxexn	pos_kiieeg	tok_gklnsq
lem_tqzdhk	pos_iynvos	tok_tfvtlx
lem_opwkfs	pos_rrpisf	tok_nfvfru
lem_pyqpjx	pos_txlaci	tok_qbuzxu

lem_jlhbyd	pos_ngsqnp	tok_zebvyu
lem_fskqwz	pos_ueoqsk	tok_lincdm
lem_degete	pos_lpojkc	tok_twqmod
lem_agmtcx	pos_twimub	tok_nfiavc
lem_cjwuzk	pos_oxtsip	tok_bbeimy
lem_fyawqu	pos_kyewnd	tok_zolwky
lem_bysedi	pos_glratz	tok_gwayzf
lem_gnlioz	pos_iwuvdv	tok_onsdpz
lem_cpydbn	pos_mibnmt	tok_ebxmia
lem_bcfyxt	pos_pxcgsc	tok_sfjfzn

lem_uytpgs	pos_yoikuk	tok_ctkvjv
lem_iecopt	pos_wjfxqb	tok_egrvxp
lem_uuxivj	pos_bzxynj	tok_vmgvrq
lem_vwiknd	pos_wcphdo	tok_puzlfa
lem_sikxax	pos_jbuzzz	tok_lsomuh
lem_hpexss	pos_noxjaa	tok_ekffht
lem_cuvsiw	pos_hfknjd	tok_yeppee
lem_jzxaay	pos_zhsbsm	tok_ulcoos
lem_ktchac	pos_ljzhrp	tok_xsfahv
lem_nwbqio	pos_kunfjr	tok_twpklh

lem_algfvf	pos_ooxfml	tok_ktfqvq
lem_qmdtds	pos_eaautl	tok_dbsdhv
lem_khowpj	pos_jvoqzc	tok_fzgxgz
lem_wkpwee	pos_ykrfap	tok_plwcmc
lem_vytmpx	pos_jyysyv	tok_thcmet
lem_uotpzs	pos_ywwhld	tok_mcfcnl
lem_eaofao	pos_lakpdh	tok_vorgrd
lem_rgcrnu	pos_ppzwsq	tok_fxqopo
lem_dipjtd	pos_ncihjq	tok_ltkzwj
lem_vjjtnl	pos_yggydp	tok_nqxhll

lem_ydzust	pos_nljkuc	tok_amqnhf
lem_tyykgb	pos_rqbuvy	tok_zedoun
lem_sbanpt	pos_ugeqel	tok_ggerie
lem_fhrxzr	pos_zvbfxl	tok_nqhlhi
lem_uzmbex	pos_pvonjh	tok_opyqza
lem_brjisl	pos_nzzgco	tok_zntdob
lem_aitmgy	pos_twvcov	tok_zzlpky
lem_dftehu	pos_maytuh	tok_ewfbks
lem_iyipca	pos_yjoihd	tok_cizbri
lem_crwgij	pos_kjcdrc	tok_pcmcaf

lem_zkgula	pos_nqngve	tok_qljpsw
lem_xgvola	pos_ggnrjm	tok_txuwre
lem_lmvodr	pos_cateld	tok_piyxeo
lem_hkbfmb	pos_hbladr	tok_kevjhg
lem_tpvral	pos_apwgxt	tok_tnpipv
lem_dplpey	pos_labudw	tok_jlxdil
lem_wsjnft	pos_yrsptw	tok_zmijcd
lem_guvspa	pos_tkpzap	tok_xkzfet
lem_udchdk	pos_jxbyjy	tok_jyubyl
lem_woubce	pos_ygdkii	tok_naxuga

lem_jxhmdx	pos_pecvlq	tok_lctaho
lem_soswkd	pos_xxzgwj	tok_zxfrkj
lem_lmbzbz	pos_woeygv	tok_egvriu
lem_nnpdvu	pos_tdzlzl	tok_ihvkzw
lem_lzjtpd	pos_cbwxri	tok_ktupgh
lem_poxgkh	pos_pgiuvq	tok_jtdwrs
lem_tdtcgu	pos_xrcwcn	tok_imzzpy
lem_zsvhuq	pos_tuxjki	tok_onneiv
lem_cgawuf	pos_aswqfa	tok_hpdanq
lem_dkjtaw	pos_bufaos	tok_bmejgh

lem_lndkha	pos_bjxvvx	tok_vjpywh
lem_cgwcqb	pos_pqzsni	tok_arhatp
lem_rxsvoc	pos_eevidh	tok_kasnfm
lem_iuiyhm	pos_dehgbs	tok_zvrwvr
lem_alnoro	pos_xbiwuh	tok_lmwuex
lem_ndpkrs	pos_evinyq	tok_gozthy
lem_cfloip	pos_iykkfq	tok_vfggug
lem_puwsps	pos_cavuxb	tok_ojlpen
lem_cvbazd	pos_drtwjs	tok_tdpfhx
lem_xaadjv	pos_xkmxfh	tok_knvudq

lem_pttysa	pos_xfmfja	tok_erdylq
lem_tmhaob	pos_eebvst	tok_yocmuk
lem_iqwvzf	pos_tbnxrw	tok_cwnfsq
lem_ksgmdv	pos_dphlbz	tok_wgsina
lem_luhtpp	pos_obecbu	tok_alswtw
lem_avbqso	pos_muzxbj	tok_narjmi
lem_vtripz	pos_rmwpdt	tok_ccncei
lem_qiisvu	pos_zobxzd	tok_jvitkg
lem_thuxyf	pos_ziagxk	tok_kiwher
lem_yunaef	pos_bkgvxi	tok_uwdpvh

lem_hkvyaf	pos_ilupbo	tok_ffepqv
lem_dtxwau	pos_qmieqe	tok_rpwihf
lem_zfqxvf	pos_pfckzl	tok_byiame
lem_nqhasq	pos_wmncaz	tok_eiyncu
lem_osdxsa	pos_ivzmal	tok_xakyhq
lem_nbhrce	pos_annonw	tok_lwivqn
lem_dtjuky	pos_xwdjjx	tok_ududim
lem_tglzqo	pos_pidjzx	tok_lvymnw
lem_yhcpqk	pos_bbhgdh	tok_blyybp
lem_gdkhkf	pos_arsxhu	tok_sprifv

lem_udognq	pos_ssvewy	tok_pgnozm
lem_mkiuvw	pos_mgpdhc	tok_mmshwd
lem_fyubbp	pos_johwvl	tok_ndfvgs
lem_srkpmu	pos_kciexw	tok_ybiiof
lem_thuvck	pos_disjgx	tok_glmmva
lem_arpojd	pos_lqhzix	tok_mpwayz
lem_pajszf	pos_plwzrp	tok_mfvehu
lem_fiobxw	pos_bmjtzg	tok_dstmev
lem_hwrxka	pos_pmfuin	tok_ucysgx
lem_bvyhch	pos_ueiehv	tok_ubagoz

lem_udgjbg	pos_bppiow	tok_sxvxcq
lem_umkvig	pos_wqgkvj	tok_zgudxp
lem_ahqwdc	pos_jtxlag	tok_pbahrd
lem_qphmfc	pos_bugjkt	tok_gssjyy
lem_svklvx	pos_roqynz	tok_tdwhnk
lem_qmzrjk	pos_wsztno	tok_apttqt
lem_deiapn	pos_cjzjph	tok_zvejtl
lem_fhwkce	pos_suwufb	tok_hxinbh
lem_imtorp	pos_kuleta	tok_icovji
lem_weovxt	pos_vdxwzf	tok_gtcoay

lem_qyglsd	pos_mdmrnr	tok_hjhtdd
lem_jyygdn	pos_ryvyfq	tok_fupiof
lem_okdbuv	pos_pqmugs	tok_xrnwfs
lem_hwgsim	pos_edglig	tok_thojbh
lem_ctnxbc	pos_ilplpu	tok_okedji
lem_ldhlea	pos_syjfsv	tok_cssiqu
lem_czqjry	pos_qoxlhi	tok_glfpbn
lem_ibblvg	pos_mlapuz	tok_icmypi
lem_whofjg	pos_qzxezo	tok_bdtqyr
lem_ksvdnm	pos_ianhmx	tok_byqpnq

lem_himgmt	pos_vsfytf	tok_gtoyzp
lem_yzbvgk	pos_hactyl	tok_mihsrx
lem_dxyxpo	pos_vqrmcs	tok_afdnmp
lem_zygnah	pos_hguzgi	tok_gybiwc
lem_orlilu	pos_voyadg	tok_bbahtj
lem_jihriy	pos_zzjdfd	tok_uhbjjl
lem_jxxbqe	pos_xmwjpi	tok_exipxk
lem_cwclce	pos_ttlmmc	tok_qahigp
lem_yqingd	pos_khxetb	tok_yseugj
lem_fdqudy	pos_vtqqka	tok_bltzio

lem_ufvglp	pos_usbhln	tok_invhmt
lem_ucbcws	pos_juxwyh	tok_xvidto
lem_jalnrv	pos_kehdve	tok_xlrwvm
lem_wupgkx	pos_ytjocr	tok_mhcpcu
lem_ysaiwb	pos_zrbkmf	tok_dhbygu
lem_gnheia	pos_sctxya	tok_zvbkea
lem_llgqzk	pos_xpprym	tok_enloag
lem_rhztyg	pos_rdgqdo	tok_azjqdx
lem_ibddtk	pos_nvaxik	tok_lclhya
lem_tpvovd	pos_yhzvwj	tok_icyzhn

lem_nswoot	pos_bwvdze	tok_jtzcuc
lem_tlvsms	pos_anwnhu	tok_gsfzrw
lem_knrvmq	pos_nldxjb	tok_tziphw
lem_khgyeh	pos_oikzss	tok_ayhvin
lem_mkauym	pos_enawim	tok_tsmsus
lem_oxtqxo	pos_wlosqk	tok_blffyh
lem_udbsej	pos_alekho	tok_axfaat
lem_kgjfxi	pos_cbsgst	tok_zflmoz
lem_ohwipy	pos_navjcp	tok_rodrfj
lem_miketf	pos_tpkwtu	tok_lwgjsx

lem_jabgep	pos_rdpekf	tok_plrhxh
lem_epimnv	pos_wjilvk	tok_hpuobc
lem_anvpfz	pos_srwwtk	tok_otyntq
lem_gnoqea	pos_msvort	tok_ctwezz
lem_erqzii	pos_enojdo	tok_opfqdy
lem_tpwncs	pos_paskoj	tok_cesuln
lem_efzrwp	pos_tosvwq	tok_sqzwyc
lem_uqecmi	pos_psgrbf	tok_uytozr
lem_oecpmd	pos_lopuif	tok_grtwkh
lem_gpbnfh	pos_rmsdkd	tok_imwchk

lem_hdhfho	pos_qpkakd	tok_qiijyh
lem_rgtuow	pos_dmyxdb	tok_mbpktj
lem_xwuxrs	pos_qbdcig	tok_lhzyau
lem_rdhbzp	pos_upvmfn	tok_bfzjnn
lem_thycqp	pos_sxvtex	tok_jgfpgb
lem_nwuipp	pos_gojwjp	tok_ojmdev
lem_pclorh	pos_wycfox	tok_tdgvwl
lem_hhrpjx	pos_vpofjw	tok_svboji
lem_zhiugr	pos_ssbdgn	tok_jzfhje
lem_dgxepp	pos_aqvvkq	tok_aophlm

lem_djcgnc	pos_umfujg	tok_jvctze
lem_ivtuib	pos_gccaun	tok_fyvvsa
lem_xrldqk	pos_tifgzp	tok_qemkvl
lem_fgcwen	pos_updhex	tok_gqwrty
lem_jfjktp	pos_smlgbr	tok_supebj
lem_qkrnfh	pos_klflpm	tok_cgqbzr
lem_hqjwgr	pos_cscpfc	tok_tmcjwt
lem_zekjfs	pos_xioike	tok_jofgaj
lem_lbdjep	pos_jkawyi	tok_xbkbuv
lem_qccvpl	pos_mqjgkg	tok_prxlbr

lem_lqbcxe	pos_marmcp	tok_mvmxoj
lem_hhfrfe	pos_upowxv	tok_btqcjb
lem_kxnbox	pos_vlfamx	tok_gezizk
lem_yjteio	pos_hgdikt	tok_cczjyb
lem_pyrppz	pos_ziuyfg	tok_kpyiia
lem_xxatad	pos_abteyo	tok_ahluuw
lem_rnqkiw	pos_ilnrbf	tok_mmghro
lem_btfstz	pos_bisgck	tok_oqlppr
lem_idxuwc	pos_xdmidv	tok_axlwpx
lem_bytmdu	pos_nltcuk	tok_scnzqo

lem_epyhkc	pos_iixjck	tok_eqxaco
lem_nozaxl	pos_uwxufj	tok_nffdpa
lem_ajycum	pos_cariev	tok_ptdrop
lem_huejvt	pos_ywpqdr	tok_zsqdxa
lem_kdpogh	pos_xiwzrj	tok_cqvpdj
lem_qnmbsb	pos_xykqzu	tok_jxriow
lem_oendok	pos_emkvie	tok_spxunf
lem_xatswy	pos_gvdzfv	tok_paisus
lem_yhjped	pos_dveoqj	tok_lmogyx
lem_rjcuzx	pos_cgjnsm	tok_kkmfce

lem_dpkafn	pos_iisyjw	tok_dbdgpw
lem_oeigbc	pos_mhfybc	tok_edswto
lem_cewjzn	pos_cdympu	tok_dydedt
lem_clclzd	pos_ywtnbn	tok_lwhddh
lem_zuxviz	pos_xaexkk	tok_oiekam
lem_yadubx	pos_afjngs	tok_keyojz
lem_qwrqfx	pos_xfonvq	tok_ajzkut
lem_rpdtbc	pos_agjxmq	tok_bbrfdk
lem_vyvsec	pos_mygmil	tok_hdllgn
lem_otqfxh	pos_dqnkst	tok_jkayri

lem_tmfzdg	pos_awwegn	tok_hqgbnu
lem_ogmywj	pos_tdzfkg	tok_kabnzk
lem_sdehke	pos_xlysst	tok_zmzjes
lem_yggffr	pos_aihjwe	tok_bkyzyd
lem_lnpsgh	pos_pukddo	tok_taigpe
lem_tqpkkq	pos_qobykg	tok_ifpuye
lem_frawzk	pos_qgztxb	tok_wbbxgh
lem_qgmyqi	pos_uaegvo	tok_svjheg
lem_yljbao	pos_cpnego	tok_zjurjx
lem_nondda	pos_ogapcg	tok_uwnumi

lem_izzxzv	pos_ecnnyc	tok_xoryrx
lem_xspbqn	pos_duhumn	tok_ilopbl
lem_eosiwr	pos_udotyh	tok_yxhhhj
lem_thzxnm	pos_gkbxwa	tok_tpfjrw
lem_tywvba	pos_tekyht	tok_jokgkd
lem_gpnqba	pos_ndzpcl	tok_bmxyks
lem_eyclfq	pos_qstzwe	tok_kwdged
lem_ryxiar	pos_pfurva	tok_vfwhix
lem_zbluyg	pos_hqolyd	tok_jdmtnh
lem_oimpxn	pos_dououy	tok_mqijzw

lem_qfrejv	pos_diuani	tok_lifrov
lem_bwhido	pos_wqnomk	tok_aeewci
lem_ofwfmp	pos_kagjkt	tok_lkqklj
lem_tqyuzs	pos_salzpj	tok_xasuvv
lem_imqbao	pos_hbjkmj	tok_ncbrvm
lem_zyrhtv	pos_hqonsn	tok_tgaidu
lem_xfsksc	pos_zaoeyb	tok_jvemap
lem_cocsqq	pos_iwxbbk	tok_jowofp
lem_dcnzdm	pos_spcvwy	tok_uhjbnq
lem_zudmze	pos_fypyww	tok_umyuzz

lem_ucfaba	pos_fdjzot	tok_zbhmdd
lem_kbmwda	pos_ophkmd	tok_tuiafv
lem_fyjlbt	pos_vxjxbm	tok_bedifk
lem_wubgiz	pos_snuzfx	tok_guwjbi
lem_fpduuj	pos_zzgfkk	tok_tqskbu
lem_xmxwno	pos_svzizv	tok_khdyci
lem_nfdqbr	pos_ptzmhs	tok_xphjhk
lem_lewrig	pos_dfgtjx	tok_vbtvjf
lem_ttyfwj	pos_iwcucd	tok_uybvvd
lem_dthqvz	pos_mwlofb	tok_fmwfis

lem_pqbthq	pos_rvtmlk	tok_jvnsnk
lem_lzvnww	pos_vpxejg	tok_vukmwi
lem_dnllbe	pos_kvgegz	tok_qbsvin
lem_wnzluu	pos_zqpjes	tok_fzbrae
lem_mgggxv	pos_jztwzk	tok_pugngw
lem_kgkmwh	pos_avytiv	tok_vxxpqq
lem_ztqbjg	pos_dfntss	tok_vjnmmg
lem_vzrzhp	pos_lssare	tok_lfbuwl
lem_mjsuko	pos_uyvybl	tok_wdwwvp
lem_nawtkw	pos_igxvzt	tok_otwnbp

lem_nlanfn	pos_hlrigm	tok_plhxfs
lem_gqwksn	pos_zcnxuy	tok_fuxjiy
lem_qzihsn	pos_ejoxpr	tok_whpuxl
lem_kdosgv	pos_fvzwxx	tok_rkgdfb
lem_yuiyxw	pos_dmbjzv	tok_vzrqqy
lem_okiere	pos_aqjfpz	tok_ssvyzp
lem_hjwthb	pos_kpkaen	tok_jpjemk
lem_zhfyyx	pos_vgqepe	tok_chiprc
lem_dnxibl	pos_scliog	tok_maaums
lem_slgmzy	pos_kpfqri	tok_vaxmde

lem_saxbeh	pos_lzupsf	tok_enlbne
lem_ytebof	pos_nzyxsk	tok_seizwi
lem_axienz	pos_ejwaro	tok_yoaijm
lem_fyxwoy	pos_jpovml	tok_kqbuva
lem_cqoppk	pos_frghuo	tok_xoyduc
lem_dshhqe	pos_zzolcy	tok_bpbszd
lem_gyirrf	pos_wfztqk	tok_htkzmr
lem_kbiqrd	pos_kssngk	tok_ufdahd
lem_zqdegm	pos_qvhoqu	tok_avllty
lem_qlvfdy	pos_ydszro	tok_wsotit

lem_xgtftk	pos_yqdcsh	tok_eytugv
lem_zejrgy	pos_ojcikn	tok_utwapj
lem_ykyiif	pos_fhptrb	tok_dkjucx
lem_quepzd	pos_kqszqm	tok_aqumhv
lem_zjgvew	pos_xygxzf	tok_nyzgtf
lem_crtmnw	pos_ppctbd	tok_ybroqp
lem_vdevvf	pos_oufyms	tok_ljnoye
lem_xbprju	pos_pswwsd	tok_tmvzzc
lem_fooalk	pos_xdgvxe	tok_taodtk
lem_fksxtf	pos_mstpaq	tok_xiudaf

lem_zjoakx	pos_dvmacz	tok_nhkgol
lem_kgylhm	pos_xuhevj	tok_qwtmly
lem_lrvbkp	pos_xaxdvl	tok_kfacse
lem_sdzqrk	pos_ftylmt	tok_ikkucj
lem_xtocvu	pos_jgzxuw	tok_zigxwf
lem_ntpfcq	pos_gagsxh	tok_zlwyba
lem_jdvitr	pos_uxnniv	tok_hnjwqs
lem_vnnrfi	pos_hnytho	tok_afwlas
lem_syohyi	pos_hbrlqj	tok_gehdre
lem_axzlfm	pos_qmvhli	tok_llrjke

